- arise, rising: adj
- throughout + the day/month/year
- throughout = during: trong suot
- another: cai nao cung duoc, khong xac dinh
- Orthers: Nhung...khac So nhieu, dung khi noi den nhung doi tuong nao do khong xac dinh
- The orther: nhung ... con lai. Xac dinh, so it
- The orthers = the orther + N so nhieu
- would rather: mong muon
- be + adv + adj
- enclosed: dinh kem
- many + so nhieu
- majority: phan lon
- pomotional - khuyen mai
- anccompanied: dinh kem
- considerable: dang ke
- ongoing(adj): lien tuc
- ease(v) lam giam
- demonstrate: the hien chung minh
- congestion: tat duong
- fulfilling: lam thoa man
- conductive: dan truyen
- prior (+to): truoc
- invalidate = cacellation: huy
- decade: bo muoi, nhom muoi, muoi lam
- force: buoc, bat buoc
- take + to + do + ST: can thiet, mat bao lau de lam gi
- expenses: chi phi sinh hoat
- accommondation: cho o
- regard: lien quan
- fallen: giam
- real estate: bat dong san
- dramatically: dang ke
- refused: tu choi­­­­­­­­
- aquired: mua
- oversea: nuoc ngoai
- domestically: noi dia
- policy: chinh sach
- resigning: thoi viec, tu chuc
- retain: giu lai
- dealing: giao dich
- in order to (+V): de ma
- as well as: cung nhu
- their work shift: ca lam viec
- such: nhu vay
- donation: su tang cho, su bieu
- respond: su phan hoi
- correspond: su phan hoi
- because,therefore,when + clause
- with + Noun
- conducted: tien hanh
- offset: bu dap
- such as: bang cach
- keep pace/up with: bat kip, theo kip voi
- inquire: dieu tra, tham tra
- attach ST for: dinh kem ST cho ...
- retail: ban le
- use to + V: da tung lam gi
- be/get use to + Ving: quen dan voi
- be of use: huu ich
- impose +(ST on): ap dat dieu gi
- be subject to: tuy thuoc
- significant: dang ke
- expand: mo rong
- renew(verb) renewed(adj) renewing(verb) renewal(noun)
- of the highest caliber: co nang luc tot nhat
- associate: phu ta, tro li
- attend of ceremony: tham giu le ki niem
- intrustor: nguoi huong dan
- inquire(v): hoi
- take advange of: loi dung, boc lot
- exploit: loi dung, boc lot
- critized: chi trich
- facility: co so
- medical coverage = health insurance: bao hiem y te
- waste product: phe pham
- processing plant: nha may che bien
- packaging plant: nha may dong goi
- automotobile manufacturing: sx mo to
- honor(v,noun): vinh du, danh du, ve vang
- cadidate: ung vien
- related to: lien quan voi
- recuit: tuyen mo
- prosper(n): thanh cong, trien vong
- self employed: tu kinh doanh
- rapid growth: su tang truong nhanh
 